level = 001
best_score = 101
limited_step = 100
dimensionx = 010
dimensiony = 010

##########
#   # #  #
#  $     #
#      . #
#    #   #
#    @   #
#        #
#        #
# .$     #
##########


level = 002
best score = 101
limited_step = 100
dimensionx = 010
dimensiony = 010


##########
##########
#######  #
###      #
#     .  #
# #  $ $ #
#        #
##### $$.#
### @    #
##########


level = 003
best score = 101
limited_step = 100
dimensionx = 010
dimensiony = 010


##########
#       ##
# $    ###
#. ## . ##
# ####  ##
#   #   ##
#$$ #. ###
# # # $@##
# .    ###
##########


level = 004
best score = 101
limited_step = 100
dimensionx = 010
dimensiony = 010


##########
#.########
#  #######
# $  $@###
# . . ####
# # $$ . #
# #    ###
# ##### ##
#        #
##########