level = 001
best_score = 014
limited_step = 100
dimensionx = 010
dimensiony = 010

##########
### /    #
### H    #
#        #
#.$ & M* #
#   .    #
#   +    #
#   +&   #
#  #@#   #
##########


level = 002
best_score = 017
limited_step = 50
dimensionx = 010
dimensiony = 010

##########
#&  .## &#
#   $    #
#        #
##       #
#  .$@   #
#        #
#    M   #
#     # *#
##########


level = 003
best_score = 999
limited_step = 50
dimensionx = 010
dimensiony = 010

##########
##########
#####  # #
### /    #
# H   .  #
#    $ $ #
#        #
##### @$.#
###      #
##########


level = 004
best_score = 071
limited_step = 200
dimensionx = 010
dimensiony = 010

##########
#       ##
# $    ###
#. ## . ##
# ####  ##
#   #   ##
#$$ #. ###
# # # $@##
# .    ###
##########


level = 005
best score = 999
limited_step = 200
dimensionx = 010
dimensiony = 010

##########
#.########
#  #######
# $  $@###
# . . ####
# # $$ . #
# #    ###
# ##### ##
#        #
##########


level = 006
best score = 999
limited_step = 200
dimensionx = 010
dimensiony = 010

##########
##########
# .   ####
#  #  #  #
#  #$.   #
# ##  $. #
#  .#$#  #
# $ #@## #
#   #### #
##########


level = 007
best score = 999
limited_step = 200
dimensionx = 010
dimensiony = 010

##########
######   #
##### $  #
###### $ #
##### $  #
###### @.#
######  ##
#####.$ .#
###  .   #
##########
